%%%%%%%%%%%%%%%%%%%%%%
% %%        % %      %
%    %%%%%% % %%%%%% %
%%%%%%     ...%      %
%    % %%%%%%.%% %%%%%
% %%%% %    ..   %   %
%        %%%.%%%   % %
%%%%%%%%%%... %%%%%% %
%..........%%        %
%%%%%%%%%%%%%%%%%%%%%%