%%%%%%%%%%%%%%%%%%%%%%%%%%%%%%%%%%%%
%                        ..........%
% %%%%%%%%%%%%%%%%%%%%%%%.%%%%%%%% %
% %%   %   %......%%%%%%%...%%     %
% %% % % % %.%%%%.%%%%%%%%%.%% %%%%%
% %% % % % %...  ........%%.%%     %
% %% % % % % %.%%%%  %%%....%%%%%% %
% %  % % %   %....%% %%%%%%%%      %
% %% % % %%%%%%%%.%%        %% %%%%%
% %% %   %%.......%%%%%%%%% %%     %
%    %%%%%%.%%%%%%%......%% %%%%%% %
%%%%%%......%.......%%%%.%% %      %
%......%%%%%%.%%%%% %....%% %% %%%%%
%.%%%%%%......%.......%%%%% %%     %
%........%%%%%%.%%%%%%%%%%% %%  %% %
%%%%%%%%%%......            %%%%%% %
%..........%%%%%%%%%%%%%%%%        %
%%%%%%%%%%%%%%%%%%%%%%%%%%%%%%%%%%%%