%%%%%%%%%%%%%%%%%%%%%%%%%%%%%%%%%%%%
%..................................%
%.%%%%%%%%%%%%%%%%%%%%%%% %%%%%%%% %
%.%%...%...%      %%%%%%%   %%     %
%.%%.%.%.%.% %%%% %%%%%%%%% %% %%%%%
%.%%.%.%.%.%........     %% %%     %
%.%%.%.%.%.%.% %%%%..%%%    %%%%%% %
%.% .%.%.%...%    %%.%%%%%%%%      %
%.%%.%.%.%%%%%%%% %%........%% %%%%%
%.%%.%...%%       %%%%%%%%%.%%     %
%....%%%%%% %%%%%%%      %%.%%%%%% %
%%%%%%      %       %%%% %%.%      %
%      %%%%%% %%%%% %    %%.%% %%%%%
% %%%%%%      %       %%%%%.%%     %
%        %%%%%% %%%%%%%%%%%.%%  %% %
%%%%%%%%%%..................%%%%%% %
%..........%%%%%%%%%%%%%%%%        %
%%%%%%%%%%%%%%%%%%%%%%%%%%%%%%%%%%%%