%%%%%%%%%%%%%%%%%%%%%%%%%%%%%%%%%%%%
%                        ..........%
% %%%%%%%%%%%%%%%%%%%%%%%.%%%%%%%% %
% %%   %   %......%%%%%%%...%%     %
% %% % % % %.%%%%.%%%%%%%%%.%% %%%%%
% %% % % % %...  ........%%.%%     %
% %% % % % % %.%%%%..%%%....%%%%%% %
% %  % % %   %....%% %%%%%%%%      %
% %% % % %%%%%%%%.%%        %% %%%%%
% %% %   %%.......%%%%%%%%% %%     %
%    %%%%%%.%%%%%%%      %% %%%%%% %
%%%%%%......%.......%%%% %% %      %
%......%%%%%%.%%%%%.%    %% %% %%%%%
%.%%%%%%......%.....  %%%%% %%     %
%........%%%%%%.%%%%%%%%%%% %%  %% %
%%%%%%%%%%......            %%%%%% %
%..........%%%%%%%%%%%%%%%%        %
%%%%%%%%%%%%%%%%%%%%%%%%%%%%%%%%%%%%