%%%%%%%%%%%%%%%%%%%%%%%%%%%%%%%%%%%%
%                                 .%
% %%%%%%%%%%%%%%%%%%%%%%% %%%%%%%%.%
% %%   %   %......%%%%%%%   %%.....%
% %% % % % %.%%%%.%%%%%%%%% %%.%%%%%
% %% % % % %...  ....    %% %%.....%
% %% % % % % %.%%%% .%%%    %%%%%%.%
% %  % % %   %....%%.%%%%%%%% .....%
% %% % % %%%%%%%%.%%........%%.%%%%%
% %% %   %%.......%%%%%%%%%.%%.....%
%    %%%%%%.%%%%%%%......%%.%%%%%%.%
%%%%%%......%.......%%%%.%%.% .....%
%......%%%%%%.%%%%% %....%%.%%.%%%%%
%.%%%%%%......%.......%%%%%.%%.....%
%........%%%%%%.%%%%%%%%%%%.%%  %%.%
%%%%%%%%%%......           .%%%%%%.%
%..........%%%%%%%%%%%%%%%%........%
%%%%%%%%%%%%%%%%%%%%%%%%%%%%%%%%%%%%