%%%%%%%%%%%%%%%%%%%%%%%%%%%%%%%%%%%%
%.........................        .%
%.%%%%%%%%%%%%%%%%%%%%%%%.%%%%%%%%.%
%.%%...%...%      %%%%%%%...%%.....%
%.%%.%.%.%.% %%%% %%%%%%%%%.%%.%%%%%
%.%%.%.%.%.%...    ......%%.%%.....%
%.%%.%.%.%.%.%.%%%%..%%%....%%%%%%.%
%.% .%.%.%...%....%%.%%%%%%%% .....%
%.%%.%.%.%%%%%%%%.%%........%%.%%%%%
%.%%.%...%%.......%%%%%%%%%.%%.....%
%....%%%%%%.%%%%%%%......%%.%%%%%%.%
%%%%%%......%.......%%%%.%%.% .....%
%......%%%%%%.%%%%% %....%%.%%.%%%%%
%.%%%%%%......%.......%%%%%.%%.....%
%........%%%%%%.%%%%%%%%%%%.%%..%%.%
%%%%%%%%%%......           .%%%%%%.%
%..........%%%%%%%%%%%%%%%%........%
%%%%%%%%%%%%%%%%%%%%%%%%%%%%%%%%%%%%