%%%%%%%%%%%%%%%%%%%%%%%%%%%%%%%%%%%%
%..................................%
%.%%%%%%%%%%%%%%%%%%%%%%% %%%%%%%% %
%.%%...%...%......%%%%%%%   %%     %
%.%%.%.%.%.%.%%%%.%%%%%%%%% %% %%%%%
%.%%.%.%.%.%.    ...     %% %%     %
%.%%.%.%.%.%.% %%%%..%%%    %%%%%% %
%.% .%.%.%...%    %%.%%%%%%%%      %
%.%%.%.%.%%%%%%%% %%........%% %%%%%
%.%%.%...%%       %%%%%%%%%.%%     %
%....%%%%%% %%%%%%%      %%.%%%%%% %
%%%%%%      %       %%%% %%.%      %
%      %%%%%% %%%%% %    %%.%% %%%%%
% %%%%%%      %       %%%%%.%%     %
%        %%%%%% %%%%%%%%%%%.%%  %% %
%%%%%%%%%%..................%%%%%% %
%..........%%%%%%%%%%%%%%%%        %
%%%%%%%%%%%%%%%%%%%%%%%%%%%%%%%%%%%%