%%%%%%%%%%%%%%%%%%%%%%%%%%%%%%%%%%%%
%                        ..........%
% %%%%%%%%%%%%%%%%%%%%%%%.%%%%%%%% %
% %%   %   %      %%%%%%%...%%     %
% %% % % % % %%%% %%%%%%%%%.%% %%%%%
% %% % % % %  ...........%%.%%     %
% %% % % % % %.%%%%..%%%....%%%%%% %
% %  % % %   %....%% %%%%%%%%      %
% %% % % %%%%%%%%.%%        %% %%%%%
% %% %   %%.......%%%%%%%%% %%     %
%    %%%%%%.%%%%%%%      %% %%%%%% %
%%%%%%......%.......%%%% %% %      %
%......%%%%%%.%%%%%.%    %% %% %%%%%
%.%%%%%%......%.....  %%%%% %%     %
%........%%%%%%.%%%%%%%%%%% %%  %% %
%%%%%%%%%%......            %%%%%% %
%..........%%%%%%%%%%%%%%%%        %
%%%%%%%%%%%%%%%%%%%%%%%%%%%%%%%%%%%%