%%%%%%%%%%%%%%%%%%%%%%
% %%        % %      %
%    %%%%%% % %%%%%% %
%%%%%%......  %      %
%    %.%%%%%% %% %%%%%
% %%%%.%.....    %   %
%     ...%%%.%%%   % %
%%%%%%%%%%... %%%%%% %
%..........%%        %
%%%%%%%%%%%%%%%%%%%%%%