%%%%%%%%%%%%%%%%%%%%%%
% %%        % %      %
%    %%%%%% % %%%%%% %
%%%%%%......  %      %
%    %.%%%%%% %% %%%%%
% %%%%.%.........%...%
%     ...%%% %%%...%.%
%%%%%%%%%%....%%%%%%.%
%..........%%........%
%%%%%%%%%%%%%%%%%%%%%%