%%%%%%%%%%%%%%%%%%%%%%%%%%%%%%%%%%%%
%..................................%
%.%%%%%%%%%%%%%%%%%%%%%%% %%%%%%%% %
%.%%...%...%......%%%%%%%   %%     %
%.%%.%.%.%.%.%%%%.%%%%%%%%% %% %%%%%
%.%%.%.%.%.%. ....       %% %%     %
%.%%.%.%.%.%.%.%%%%  %%%    %%%%%% %
%.% .%.%.%...%....%% %%%%%%%%      %
%.%%.%.%.%%%%%%%%.%%        %% %%%%%
%.%%.%...%%.......%%%%%%%%% %%     %
%....%%%%%%.%%%%%%%      %% %%%%%% %
%%%%%%......%.......%%%% %% %      %
%......%%%%%%.%%%%%.%    %% %% %%%%%
%.%%%%%%......%.....  %%%%% %%     %
%........%%%%%%.%%%%%%%%%%% %%  %% %
%%%%%%%%%%......            %%%%%% %
%..........%%%%%%%%%%%%%%%%        %
%%%%%%%%%%%%%%%%%%%%%%%%%%%%%%%%%%%%