%%%%%%%%%%%%%%%%%%%%%%%%%%%%%%%%%%%%
%.........................        .%
%.%%%%%%%%%%%%%%%%%%%%%%%.%%%%%%%%.%
%.%%...%...%      %%%%%%%...%%.....%
%.%%.%.%.%.% %%%% %%%%%%%%%.%%.%%%%%
%.%%.%.%.%.%...    ......%%.%%.....%
%.%%.%.%.%.%.%.%%%%..%%%....%%%%%%.%
%.% .%.%.%...%....%%.%%%%%%%% .....%
%.%%.%.%.%%%%%%%%.%%........%%.%%%%%
%.%%.%...%%.......%%%%%%%%%.%%.....%
%....%%%%%%.%%%%%%%      %%.%%%%%%.%
%%%%%%......%.......%%%% %%.% .....%
%......%%%%%%.%%%%%.%    %%.%%.%%%%%
%.%%%%%%......%.....  %%%%%.%%.....%
%........%%%%%%.%%%%%%%%%%%.%%..%%.%
%%%%%%%%%%......           .%%%%%%.%
%..........%%%%%%%%%%%%%%%%........%
%%%%%%%%%%%%%%%%%%%%%%%%%%%%%%%%%%%%