%%%%%%%%%%%%%%%%%%%%%%%%%%%%%%%%%%%%
%                                 .%
% %%%%%%%%%%%%%%%%%%%%%%% %%%%%%%%.%
% %%   %   %......%%%%%%%   %%.....%
% %% % % % %.%%%%.%%%%%%%%% %%.%%%%%
% %% % % % %...  ....    %% %%.....%
% %% % % % % %.%%%% .%%%    %%%%%%.%
% %  % % %   %....%%.%%%%%%%% .....%
% %% % % %%%%%%%%.%%........%%.%%%%%
% %% %   %%.......%%%%%%%%%.%%.....%
%    %%%%%%.%%%%%%%      %%.%%%%%%.%
%%%%%%......%.......%%%% %%.% .....%
%......%%%%%%.%%%%%.%    %%.%%.%%%%%
%.%%%%%%......%.....  %%%%%.%%.....%
%........%%%%%%.%%%%%%%%%%%.%%  %%.%
%%%%%%%%%%......           .%%%%%%.%
%..........%%%%%%%%%%%%%%%%........%
%%%%%%%%%%%%%%%%%%%%%%%%%%%%%%%%%%%%