%%%%%%%%%%%%%%%%%%%%%%%%%%%%%%%%%%%%
%.........................        .%
%.%%%%%%%%%%%%%%%%%%%%%%%.%%%%%%%%.%
%.%%...%...%......%%%%%%%...%%.....%
%.%%.%.%.%.%.%%%%.%%%%%%%%%.%%.%%%%%
%.%%.%.%.%.%. ....  .....%%.%%.....%
%.%%.%.%.%.%.%.%%%% .%%%....%%%%%%.%
%.% .%.%.%...%....%%.%%%%%%%% .....%
%.%%.%.%.%%%%%%%%.%%........%%.%%%%%
%.%%.%...%%.......%%%%%%%%%.%%.....%
%....%%%%%%.%%%%%%%......%%.%%%%%%.%
%%%%%%......%.......%%%%.%%.% .....%
%......%%%%%%.%%%%% %....%%.%%.%%%%%
%.%%%%%%......%.......%%%%%.%%.....%
%........%%%%%%.%%%%%%%%%%%.%%..%%.%
%%%%%%%%%%......           .%%%%%%.%
%..........%%%%%%%%%%%%%%%%........%
%%%%%%%%%%%%%%%%%%%%%%%%%%%%%%%%%%%%