%%%%%%%%%%%%%%%%%%%%%%%%%%%%%%%%%%%%
%..................................%
%.%%%%%%%%%%%%%%%%%%%%%%% %%%%%%%% %
%.%%...%...%      %%%%%%%   %%     %
%.%%.%.%.%.% %%%% %%%%%%%%% %% %%%%%
%.%%.%.%.%.%...          %% %%     %
%.%%.%.%.%.%.%.%%%%  %%%    %%%%%% %
%.% .%.%.%...%....%% %%%%%%%%      %
%.%%.%.%.%%%%%%%%.%%        %% %%%%%
%.%%.%...%%.......%%%%%%%%% %%     %
%....%%%%%%.%%%%%%%      %% %%%%%% %
%%%%%%......%.......%%%% %% %      %
%......%%%%%%.%%%%%.%    %% %% %%%%%
%.%%%%%%......%.....  %%%%% %%     %
%........%%%%%%.%%%%%%%%%%% %%  %% %
%%%%%%%%%%......            %%%%%% %
%..........%%%%%%%%%%%%%%%%        %
%%%%%%%%%%%%%%%%%%%%%%%%%%%%%%%%%%%%