%%%%%%%%%%%%%%%%%%%%%%%%%%%%%%%%%%%%
%.........................        .%
%.%%%%%%%%%%%%%%%%%%%%%%%.%%%%%%%%.%
%.%%...%...%......%%%%%%%...%%.....%
%.%%.%.%.%.%.%%%%.%%%%%%%%%.%%.%%%%%
%.%%.%.%.%.%. .... ......%%.%%.....%
%.%%.%.%.%.%.%.%%%%..%%%....%%%%%%.%
%.% .%.%.%...%....%%.%%%%%%%% .....%
%.%%.%.%.%%%%%%%%.%%........%%.%%%%%
%.%%.%...%%.......%%%%%%%%%.%%.....%
%....%%%%%%.%%%%%%%      %%.%%%%%%.%
%%%%%%......%.......%%%% %%.% .....%
%......%%%%%%.%%%%%.%    %%.%%.%%%%%
%.%%%%%%......%.....  %%%%%.%%.....%
%........%%%%%%.%%%%%%%%%%%.%%..%%.%
%%%%%%%%%%......           .%%%%%%.%
%..........%%%%%%%%%%%%%%%%........%
%%%%%%%%%%%%%%%%%%%%%%%%%%%%%%%%%%%%