%%%%%%%%%%%%%%%%%%%%%%%%%%%%%%%%%%%%
%                                 .%
% %%%%%%%%%%%%%%%%%%%%%%% %%%%%%%%.%
% %%   %   %      %%%%%%%   %%.....%
% %% % % % % %%%% %%%%%%%%% %%.%%%%%
% %% % % % %             %% %%.....%
% %% % % % % % %%%%  %%%    %%%%%%.%
% %  % % %   %    %% %%%%%%%% .....%
% %% % % %%%%%%%% %%        %%.%%%%%
% %% %   %%       %%%%%%%%% %%.....%
%    %%%%%% %%%%%%%      %% %%%%%%.%
%%%%%%      %       %%%% %% % .....%
%      %%%%%% %%%%% %    %% %%.%%%%%
% %%%%%%      %       %%%%% %%.....%
%        %%%%%% %%%%%%%%%%% %%..%%.%
%%%%%%%%%%..................%%%%%%.%
%..........%%%%%%%%%%%%%%%%........%
%%%%%%%%%%%%%%%%%%%%%%%%%%%%%%%%%%%%