%%%%%%%%%%%%%%%%%%%%%%%%%%%%%%%%%%%%
%                                 .%
% %%%%%%%%%%%%%%%%%%%%%%% %%%%%%%%.%
% %%   %   %      %%%%%%%   %%.....%
% %% % % % % %%%% %%%%%%%%% %%.%%%%%
% %% % % % %  ......     %% %%.....%
% %% % % % % %.%%%%..%%%    %%%%%%.%
% %  % % %   %....%%.%%%%%%%% .....%
% %% % % %%%%%%%%.%%........%%.%%%%%
% %% %   %%.......%%%%%%%%%.%%.....%
%    %%%%%%.%%%%%%%      %%.%%%%%%.%
%%%%%%......%.......%%%% %%.% .....%
%......%%%%%%.%%%%%.%    %%.%%.%%%%%
%.%%%%%%......%.....  %%%%%.%%.....%
%........%%%%%%.%%%%%%%%%%%.%%..%%.%
%%%%%%%%%%......           .%%%%%%.%
%..........%%%%%%%%%%%%%%%%........%
%%%%%%%%%%%%%%%%%%%%%%%%%%%%%%%%%%%%