%%%%%%%%%%%%%%%%%%%%%%
% %%        % %      %
%    %%%%%% % %%%%%% %
%%%%%%     ...%      %
%    % %%%%%%.%% %%%%%
% %%%% %     ....%...%
%        %%% %%%...%.%
%%%%%%%%%%....%%%%%%.%
%..........%%........%
%%%%%%%%%%%%%%%%%%%%%%